#######
#NNNNN#
#N###N#
#NNG#N#
#N###N#
#NNNNN#
#######