############
#NNNNNNNNNN#
#N#######NN#
#NNNNNNN#NN#
#N#N###N#NN#
#N#N#N#N#NN#
#N#N#N#N#NN#
#N#N#N#N##N#
#N#G#N#NG#N#
#N###N####N#
#NNNNNNNNNN#
##########G#