#########
#NNNNNNN#
#N#N#N#N#
#NNN#NNN#
#NNNNNNN#
#N#GGG#N#
#N#####N#
#NNNNNNN#
#NNN#NNN#
#N#N#N#N#
#NNNNNNN#
#########