#########
#NNN#NNN#
#NGN#NGN#
#NNNNNNN#
###NGN###
#NNNNNNN#
#NGN#NGN#
#NNN#NNN#
#########