#########
#NNNNNNN#
#N#####N#
#N#NNNNN#
#N#N#N#N#
#NNN#NNN#
###N###N#
#NNNNN#N#
GN###N#N#
#NNNNNNN#
###G#####